############
#  P       #
#  ######  #
#     #    #
#   ! #    #
#  ####    #
#          #
#          #
#  E  E    #
#          #
#        X #
############