############
#  P       #
#  ######  #
#     #    #
#    !#    #
#  ####    #
#          #
#    E     #
#  E    E  #
#          #
#        X #
############
