############
#  P       #
# ######## #
#     #    #
# # ! #    #
# #####    #
#    E     #
#   E      #
#   E      #
#    E     #
#        X #
############