############
#  P       #
# ######## #
#     #    #
# # ! #    #
# #####    #
#          #
#          #
#          #
#     E    #
#        X #
############