############
#  P       #
#  ######  #
#  !!!#    #
#  !!!#    #
#  ####    #
#          #
#          #
#  E  E    #
#          #
#        X #
############