############
#          #
#    E     #
#   P      #
########## #
#  ! #     #
#### #     #
#          #
#    E     #
#          #
#X         #
############