############
#          #
# ######## #
#     #    #
# # ! #    #
# #####    #
#          #
#          #
#          #
#          #
#        X #
############