############
#  P #     #
#    #     #
#    #     #
#    !     #
#    #     #
#    #     #
#    # E   #
#  E #     #
#    #     #
#    #   X #
############