############
#          #
#          #
#          #
########## #
#  ! #     #
#### #     #
#          #
#          #
#          #
#X         #
############