############
#    #   X #
#    #     #
#    ##### #
#          #
#          #
#          #
#          #
#          #
#          #
###!########
############