############
#    #    X#
# P  #     #
#    #####E#
#          #
#          #
#     E    #
#          #
#          #
#          #
###!########
############
