############
#    #     #
#    #     #
#    #     #
#    !     #
#    #     #
#    #     #
#    #     #
#    #     #
#    #     #
#    #   X #
############