############
#    #     #
# P  #     #
#    ##### #
#          #
#          #
#    E     #
#          #
#    E     #
#          #
###!########
############