############
#    #   x #
#    #     #
#    ##### #
#          #
#          #
#          #
#          #
#          #
#          #
###!########
############