############
#          #
########## #
#     #    #
# # ! #    #
# #####    #
#          #
#          #
#          #
#          #
#        X #
############