############
#        X #
#          #
#          #
#          #
#          #
#          #
#          #
#          #
#          #
#          #
############