############
#         X#
#          #
#          #
#          #
#          #
#          #
#          #
#          #
#          #
#          #
############